the - the definite article
be - to exist or to happen
and - a conjunction used to connect words, phrases, or clauses
of - indicating possession or origin
a - an indefinite article
in - expressing the situation of something that is or appears to be enclosed or surrounded by something else
to - expressing motion in the direction of (a particular location)
have - to possess, own, or hold
it - used to refer to a thing previously mentioned or assumed to be common knowledge
that - introducing a clause providing information about the preceding clause
for - expressing the purpose of an action or situation
not - used to negate, prohibit, or disqualify
on - in, at, or near a particular place or object
with - in the company of; accompanied by
as - in the way or manner indicated or suggested
at - in or near a particular place
by - indicating the agent or cause of an action
this - used to indicate something that is nearby or close in time
but - except for the fact; however
his - belonging to or associated with a male person previously mentioned or assumed to be common knowledge
they - used to refer to two or more people or things previously mentioned or assumed to be common knowledge
are - to exist or to happen
from - indicating the place or source of something
or - introducing an alternative
one - used to indicate a single person or thing
had - to possess, own, or hold in the past
by - expressing the means or manner of an action
word - a unit of language that carries meaning and consists of one or more spoken or written sounds or symbols
but - introducing a clause that contrasts with or qualifies the preceding clause
what - used to ask for information about something
some - indicating an unspecified number or quantity
we - used to refer to the speaker or writer and one or more other people as the subject of a verb
can - to be able to; to have the ability or power to
out - away from the inside or the center
other - not the same; different
were - to exist or to happen in the past
all - the entire or total number or quantity of something
there - in or at that place
when - at what time
up - from a lower to a higher position or level
use - to put into service or apply for a particular purpose
your - belonging to or associated with the person or group addressed
how - in what way or manner; by what means
said - to express or state in words
an - an indefinite article
each - every single one of a group
she - used to refer to a female person previously mentioned or assumed to be common knowledge
which - introducing a clause giving information about the preceding clause
do - to perform or execute an action
their - belonging to or associated with a group of people previously mentioned or assumed to be common knowledge
time - the point or period at which an event occurs
no - not any; not one
way - a method, manner, or means of doing something
could - to be able to; to have the ability or power to
people - human beings in general or considered collectively
my - belonging to or associated with the person speaking or writing
than - used to introduce the second element in a comparison
first - preceding all others in time, order, or importance
water - a clear, colorless, odorless, and tasteless liquid that is essential for the life of most animals and plants
who - used to ask for information about the identity of the subject of a clause
oil - a slippery or viscous liquid consisting of a mixture of hydrocarbons
its - belonging to or associated with a thing previously mentioned or assumed to be common knowledge
now - at the present time or moment
find - to discover or locate through search or effort
long - having a greater length than usual or expected
down - from a higher to a lower position or level
day - a period of 24 hours, especially from midnight to midnight
did - to perform or execute an action in the past
get - to obtain, acquire, or receive
come - to move or travel toward a place or person
made - to cause to be or to become; to bring about
may - to have the possibility or potential to
part - a portion, section, or division of a whole
over - across or extending from one side to the other of (something)
new - not previously known or encountered; not previously existing
sound - a vibration that travels through the air or another medium and can be heard when it reaches a person's or animal's ear
take - to grasp or grip with the hands; to hold or support with the hands or arms
only - being the single one or the sole example
little - small in size or amount
know - to be aware of through observation, investigation, or experience
place - a particular point or position in space; a location
years - a period of time equal to 12 months
live - to have life; to be alive
me - the person speaking or writing
back - at or toward the rear or the past
give - to transfer possession or ownership of (something) to (someone)
most - the greatest in number, quantity, or importance
very - to a great or high degree
after - behind in time; later than
things - objects, substances, or events considered as a group
our - belonging to or associated with the speaker or writer and one or more other people
just - only a short time before; very recently
name - a word or set of words by which a person, animal, place, or thing is known and addressed
good - having desirable or positive qualities; useful or suitable
sentence - a group of words that is complete in itself, typically containing a subject and predicate, question, exclamation, or command, and consisting of a main clause and sometimes one or more
man - an adult male human being
world - the earth, together with all of its countries, peoples, and natural features
hand - the end part of the human arm beyond the wrist, including the fingers and thumb
year - a period of time equal to 365 or 366 days, corresponding to one orbit of the earth around the sun
day - a period of 24 hours, especially from midnight to midnight
home - the place where one lives; a house or apartment
place - a particular point or position in space; a location
part - a portion, section, or division of a whole
case - a particular situation or example of something
fact - a piece of information that is known to be true or that can be proved to be true
eye - the organ of sight, in vertebrates typically one of a pair of spherical bodies contained in an orbit of the skull and in humans appearing externally as a dense, white, curved membrane, or sclera, surrounding a circular, colored portion, or iris, that is covered by a clear, curved membrane, or cornea, and in the center of which is an opening, or pupil, through which light passes to the retina
end - the final part or extremity of something
mother - a female parent
area - a portion of space or surface; a part or region
market - a place where goods and services are bought and sold
group - a number of people or things that are located, gathered, or classed together
government - the group of people who have the authority to govern a country or state
company - a group of individuals who come together for the purpose of conducting a business or industrial enterprise
problem - a matter or situation that is difficult to deal with or understand
service - an act of helpful activity; assistance
friend - a person whom one knows and with whom one has a bond of mutual affection, typically exclusive of sexual or family relations
point - a sharp or tapered end, as of a tool
night - the period of darkness between sunset and sunrise
life - the condition that distinguishes animals and plants from inorganic matter, including the capacity for growth, reproduction, functional activity, and continual change preceding death
work - activity that is directed toward making or doing something
family - a group of people who are related to each other, especially parents and their children
student - a person who is learning at a school or university